111111111111
100000110001
100010111001
100000000001
101000100001
111111111111
