11111111111111111111111111111111111111111111111111111111111111111111111111111111
10000000000000000000000000000000000000000000000000000000000000000000000000000001
10000000000000000000000000000000000000000000000000000000000010000000000000000001
10000000000000000000000000000000000000000000000000000000000000000000000000000001
10000000000000000000000000000000000000000000000000000000000000000000000000000001
10000000000000000000000000000000000000000000000000000000000100000000000000000001
10000000000000000000000000000000000000000000000000000000000000000000000000000001
10000000000000000000000000000000000000000000000001000000000000000000000000000001
10000000000000011111111110011111111100000000000000000000000000000000000000000001
10000000000000010000000000000000000100000000000000000100000000000000000000000001
10000000000000010100000111110000000100000000000000000000000000000000000000000001
10000000000000010000000100010001000100000000000000000000000000000000000000000001
10000000000000010100000100010000000100000000000000000100000000000000000000000001
10000000000000010000000111110000000100000000000000001110000000000000000000000001
10000000000000010000000000100000000100000000000000000100000000000000000000000001
10000000000000011111111111111111111100000000000000000000000000000000000000000001
10000000010111110000000000000000000000000000000000000000000000000000000000000001
10000000010000000000000000000000000000000000000000000000000000000000000000000001
10000000010000000000000000000000000000000000000000000000000000000000000000000001
10000000010000000000000000000000000000000000000000000000000000000000000000000001
10000000010000000000000000000000000000000000000000000000000000000000000000000001
10000000010000000000000000000000000000000000000000000000000000000000000000000001
10000000010000000000000000000000000000000000000000000000000000000000000000000001
10000000010000000000000000000000000000000000000000000000000000000000000000000001
11111111111111111111111111111111111111111111111111111111111111111111111111111111