NO images/retro_texture_pack/HEDGE_1A.xpm
SO images/retro_texture_pack/HEDGE_2A.xpm
WE images/retro_texture_pack/HEDGE_1C.xpm
EA images/retro_texture_pack/HEDGE_1B.xpm
C 41,179,224
F 62,204,62
1111111111111111111111
1000000000100000000001
1000000011110000000001
1000000000000000000001
1000000000110000000001
1000000000000000000001
1E00000000000000000001
1000000000000000000001
1000010000100000000001
1000010000000011111111
1000010000000000000001
1111111111111111111111
