1111111111111111111111
1000000000100000000001
1000000011110000000001
1000000000000000000001
1000000000110000000001
1000000000000000000001
1000000000000000000001
1000000000000000000001
1000110000100000000001
1000010000000011111111
1000010000000000000001
1111111111111111111111
