11111111111111111111111
10000011000000000000001
10001011100000000000001
10000000000000000000001
10100010000000000000001
11111111111111111111111
