# **************************************************************************** #
#                                                                              #
#                                                         :::      ::::::::    #
#    map.cub                                            :+:      :+:    :+:    #
#                                                     +:+ +:+         +:+      #
#    By: theo <theo@student.42.fr>                  +#+  +:+       +#+         #
#                                                 +#+#+#+#+#+   +#+            #
#    Created: Invalid date        by 00000000000       #+#    #+#              #
#    Updated: 2023/04/20 17:04:27 by theo             ###   ########.fr        #
#                                                                              #
# **************************************************************************** #

10000000000000010200000100010000000100000000000000000200000000000000000000000001
10000000000000010000000111110000000100000000000000002120000000000000000000000001
10000000000000010000000000200000000100000000000000000200000000000000000000000001
10000000000000011111111111111111111100000000000000000000000000000000000000000001
10000000010111110000000000000000000000000000000000000000000000000000000000000001
10000000010000000000000000000000000000000000000000000000000000000000000000000001
10000000010000000000000000000000000000000000000000000000000000000000000000000001
10000000010000000000000000000000000000000000000000000000000000000000000000000001
10000000010000000000000000000000000000000000000000000000000000000000000000000001
10000000010000000000000000000000000000000000000000000000000000000000000000000001
10000000010000000000000000000000000000000000000000000000000000000000000000000001
10000000010000000000000000000000000000000000000000000000000000000000000000000001
11111111111111111111111111111111111111111111111111111111111111111111111111111111