1111111111111111111111111111111111111111111
1000000000100000000001111111111111111111111
1000000011110000000001EEEEEEEEEEEEEEEEEEEE1
100000000011000000000DEEEEEEEEEEEEEEEEEEEE1
1000000000000000000001EEEEEEEEEEEEEEEEEEEE1
1000000000000000000001EEEEEEEEEEEEEEEEEEEE1
1000000000000000000001111111111111111111111
1000110000100000000001
1000010000000011111111
1000010000000000000001
1111111111111111111111
