1111111111111111111111111111111111111111111
1000000000100000000001111111111111111111111
1000000011110000000001EEEEEEEEEEEEEEEEEEEE1
100000000011000000000DEEEEEEEEEEEEEEEEEEEE1
1000000000000000000001EEEEEEEEEEEEEEEEEEEE1
1000000000000000000001EEEEEEEEEEEEEEEEEEEE1
1000000000000000000001111111111111111111111
1000110000100000000001111111111111111111111
1000010000000011111111111111111111111111111
1000010000000000000001111111111111111111111
11111111111D1111111111111111111111111111111
1111111111101111111111111111111111111111111
1111111111101111111111111111111111111111111
1111111111101111111111111111111111111111111
1111111111101111111111111111111111111111111
1111111111101111111111111111111111111111111
1111111111101111111111111111111111111111111
1111111111101111111111111111111111111111111
1111111111101111111111111111111111111111111
1111000000000000000111111111111111111111111
1110000000000000000011111111111111111111111
1111000000000000000111111111111111111111111
1111100000000000001111111111111111111111111
1111110000000000011111111111111111111111111
1111111000000000111111111111111111111111111
1111111100000001111111111111111111111111111
1111111100000001111111111111111111111111111
1111111100000001111111111111111111111111111
1111111100000001111111111111111111111111111
1111111111111111111111111111111111111111111